SO textures/red.png
WE textures/brick.png
EA textures/blue.png
NO textures/grey.png
F 34,49,63
C 1,1,112

1111111111111111111111111
1000000000111111111111111
1111111111111111111111111
1011000001110000000000001
100100000000000000000000111111111
111111111011000001110000000000001
1000000000110000011100111111111111
111101111111110111000000100011
11110111111111011101010000001
11000000110101011100000000001
1000000000000000110000000N001
10000000000000001101010010001
11000001111111111111011110001
11110111         101111010001
11111111         111111111111
