NO ./ruta_a_la_textura_norte
SO ./ruta_a_la_textura_sur
WE ./ruta_a_la_textura_oeste
EA ./ruta_a_la_textura_este
F 220,100,0
C 225,30,0

1111111111111111111111111
1000000000111111111111111
1111111111111111111111111
1011000001110000000000001
100100000000000000000000111111111
111111111011000001110000000000001
100000000011000001110111111111111
111101111111110111000000100011
11110111111111011101010000001
11000000110101011100000000001
10000000000000001100000000N01
10000000000000001101010010001
11000001111111111111011110001
11110111         101111010001
11111111         111111111111
